AAAAAAAAAAAAAAAAAAAAA
A   A       A     A A
A A AAA AAA AAA A A A
A A     A     A A A A
A AAA AAA A A A AAA A
A   A   A A A   A   A
AAA AAAAA A AAAAA A A
A   A     A     A A A
A AAA A AAAAAAA A AAA
A A A A   A   A     A
AAA A AAA AAA AAAAA A
A   A   A   A   A   A
AAA AAA AAA AAA A AAA
A     A   A   A A A A
A AAAAA A AAAAA AAA A
A A     A A     A   A
A A A AAAAA AAAAA AAA
A   A   A A   A   A A
AAA AAA A AAA A A A A
A   A           A   A
AAAAAAAAAAAAAAAAAAAAA